absolute	완전한, 완전무결한
accelerate	촉진하다, 가속화하다
acclaim	찬사, 호평
accommodate	~을 수용하다, 숙박시키다
accountant	회계사
accumulate	축적하다
accurate	정확한
accurately	정확하게
acknowledge	인정하다;(편지등의) 수령을 알리다
address	주소; 다루다, 처리하다
adequately	적절히
advance	진보, 전진
affix	(우표등을)
agreeably	쾌적하게, 기분 좋게
agreement	계약, 협정; 합의
ahead	미리, 앞서서
alliance	동맹, 제휴
allocate	할당하다, 배분하다
allow	~하게 하다, ~을 허락하다
allowance	허용치; 참작, 특별한 고려
amend	수정하다
amenity	편의 시설
annotated	(책 등이) 주석이 달린
annulment	무효화, 취소
anticipate	기대하다, 예상하다
antitrust	독점 금지의
apologize	사과하다
appearance	외관, 외양
appropriately	적절하게
approximately	대략
arbitration	중재
argumentative	논쟁적인, 논쟁을 좋아하는
assemble	조립하다
assorted	여러가지 종류의, 다채로운
assure	~에게 보장하다, ~을 안심시키다
at the latest	늦어도
atmosphere	분위기, 환경
attach	붙이다, 접착하다
attain	달성하다
attraction	관광 명소
attribute	~에 돌리다, ~의 덕분으로 돌리다
audit	회계 감사, 심사
automate	자동화하다
available	(사물이)이용 가능한; (사람이)시간이 있는
away	떨어져서
baggage	수화물
barely	가까스로, 거의 ~ 하지 않는
beforehand	이전에, 미리
belongings	소지품, 수요물
bewildering	당혹케 하는
bid	입찰
bilateral	쌍방의
blemish	흠, 결점
board	탑승하다; 이사회
breakthrough	비약적 발전
broaden	넓히다
brochure	소책자, 브로셔
budget	예산
bulk	대량의
by hand	인편으로, 손으로
calculate	계산하다
capable	~을 할 수 있는, ~할 능력이 있는
capacity	수용력, 용량
capitalize on	~을 이용하다, 기회로 삼다
carelessly	부주의하게
carton	(큰)판지 상자
cause	~을 야기하다, ~의 원인이 되다
caution	주의, 조심
challenging	도전적인, 힘든
check in	체크인하다, 숙박수속을 하다
chef	주방장
chemical	화학제품
choice	선택물, 선택사항, 선택
collaborate	공동으로 일하다, 협동하다
coming	다가오는, 앞으로 올
commitment	헌신, 전념
committee	위원회
commodity	상품, 산물
comparable	필적하는, 비교되는
compare	비교하다
compatible	호환성의, 양립할 수 있는
compensate	~에게 보상하다
complaint	불평
complement	보완하다, 보충하다
complete	완료하다, 완성하다; 완료된, 완성된
completely	전적으로, 완전히
complication	복잡한 문제
compliment	칭찬
complimentary	무료의, 우대의
compromise	타협, 화해
concurrently	동시에
confident	자신 있는
confirm	확인하다
confirmation	확인 확증
connoisseur	감정가, 감식가
consignment	위탁판매
contact	~와 연락을 취하다; 교섭하고 있는 사람
contract	계약;계약하다;수축하다
control	관리하다, 통제하다
convenience	편의, 편리
conveniently	편리하게
cooperatively	협력하여, 협조적으로
correspondence	편지, 통신문
corrosion	부식
courier	급송 택배
courteous	예의바른
critical	비판적인
cuisine	(독특한)요리
cultivation	우호 증진, 양성
curtail	~을 줄이다, 삭감하다
customs	세관
damaged	손상된, 손해를 입은
deadlock	교착 상태
deal	처리하다; 거래하다;분배하다
dealer	판매업자, 상인
declare	(세관에서)신고하다
decline	감소, 하락; 거절하다
decrease	감소하다
deduct	공제하다, 빼다
defective	결함이 있는
deficient	부족한, 불충분한
deficit	적자, 부족액
deliver	배달하다;(연설을)하다
demoralize	~의 사기를 꺾다
depart	출발하다
depend	~에 따라 결정되다, ~에 달려 있다
depot	창고, 저장소
destination	목적지
detach	떼다
development	개발, 발전
deverse	다양한
deviate	빗나가다, 일탈하다
device	장치
devise	고안하다, 발명하다
dignitary	고위관리
diminish	감소하다
disappointing	실망스러운, 실망시키는
disclose	공개하다, 드러내다
discontinue	중단하다
discrepancy	불일치, 차이
dispute	논쟁, 분쟁
disruption	중단, 혼란
distribute	배포하다, 배급하다
diversified	다양한, 여러 가지의
do business with	~와 거래하다
dramatic	극적인, 멋진
durable	내구성 있는, 튼튼한
duty	관세, 세금;의무
efficiency	효율, 능륭
efficient	능률적인, 효과적인
elegant	우아한, 고상한
embargo	무역 금지, 통상 정지
embark	착수하다, 나서다
embassy	대사관
emergency	비상사태
enact	제정하다
enclose	~을 동봉하다; ~을 에워싸다
encompass	포함하다, 둘러싸다
encouraging	용기를 북돋워주는
engrave	(문자, 도안 등을)~에 새기다
ensure	보증하다, 확실하게 하다
entirely	완전히
envelope	봉투
enviable	부러워할 만한, 샘나는
envision	상상하다, 계획하다
equipment	장비, 설비
escort	~을 바래다 주다, 에스코트하다
evaluation	평가
evidently	분명히, 명백히
exceed	~을 초과하다
excess	초과, 초과량
exempt	면제된, ~이 없는
exotic	이국적인, 매혹적인
expedite	신속히 처리하다, 진척시키다
expenditure	지출, 비용
expire	만기가 된다
extensive	광범위한, 넒은
fabricate	제작하다
facility	시설
factor	요소, 원인
feature	특징, 특색
figure	합계 수, 총액
fill	~을 채우다
fill out/in	(서류에)적어넣다
financial	재정의, 금전상의
finished	완성된
fiscal	회계의, 재정상의
fix	수리하다
flavor	맛, 풍미
following	~후에
for tree	무료로
forfeit	잃다, 몰수당하다
foundation	토대, 기초
fragile	깨지기 쉬운
freshness	신선함
fund	자금; 자금을 공급하다
further	그 이상의
generate	창출하다, 야기하다
genuine	진짜의, 진품의
grant	주다, 수여하다; 보조금
growth	성장, 발전
guarantee	보장하다;보장
halt	중단, 정지
handle	다루다, 취급하다
hesitate	주저하다
hold	~을 담다, ~을 수용하다
hospitality	환대, 친절
illustrate	설명하다, 예증하다
impartially	공명정대하게, 치우치지 않게
imperative	반드시 해야 하는, 필수적인
impose	부과하다
impression	인상
impressive	굉장한, 인상적인
improve	개선하다, 향상시키다
in the red	적자 상태인
inaccurate	부정확한
inaugurate	정식으로 ~을 개시하다
incidental	부수적인
inconsistency	불일치
inconvenience	불편
incorrect	부정확한
increase	증가; 증가하다
increasingly	점점, 더욱 더
incur	(손실읍)입다, (빚을)지다
indication	징후, 조짐
indicative	나타내는, 암시하는
indigenous	지역 교유의, 토착의
indulge	탐닉하다, 빠지다
inevitable	불가피한
inflation	인플레이션, 물가상승, 통화팽창
infuriate	격분시키다, 화나게하다
infusion	주입, 혼합
initially	처음에, 초기에
innovative	혁신적인
inquire	질문하다
insert	삽입하다
inspect	~을 조사하다, 검사하다
inspiration	영감
international	국제적인
interpretation	해석, 설명
inventory	재고픔, 재고목록
invoice	송장, 인보이스
itinerary	여행 일정(표)
jet lag	시차증
keep track of	~을 계속 알고 있다, ~에 대해 끊임없이 정보를 얻어내다
launch	출시하다
laundry	세탁물
ledger	회계 장부
liability	책임;(-ties)부채, 채무
liable	책임져야 할; ~하기 쉬운
locate	찾아내다,~을 위치시키다
make	~을 하다, ~을 만들다
make up for	~을 만회하다, 보상하다
manufacturer	제조회사, 제조업자
markedly	현저하게, 눈에 띄게
material	재료, 물질
meagerly	빈약하게, 불충분하게
mediation	조정, 중재
minimally	극히 작게, 최소한으로
missing	행방 불명의, 사라진
mistakenly	잘못되게, 틀리게
moderator	(토론 등의) 사회자, 중재자
modify	일부 변경하다, 수정하다
monetary	금전의, 재정적인
narrow	좁히다
negotiation	교섭, 협상
notification	통지
oblige	~에게 강요하다, 할 수 없이 ~ 하게 하다
obsolete	시대에 뒤떨어진, 구식의
occupancy	이용률
ocontainer	그릇, 용기
offset	상쇄하다, 벌충하다
operate	작동하다, 움직이다
operational	작동하는, 작동 가능한
opposing	대립하는, 반대하는
order	주문하다
originally	원래, 처음에는
outlay	지출, 경비
overcome	극복하다
overhead	머리 위의
particularly	특히
patent	특허원, 특허품
patronize	~을 단골로 삼다, ~와 거래하다
percentage	백분율
perishable	부패하기 쉬운
place	~을 한 상태에 두다; (주문을)하다
polish	~을 닦다, ~의 윤을 내다
politely	예의 바르게
postage	우편 요금
power	전력, 전기
preamble	서론, 서문
precaution	예방조치, 예방책
precisely	정확히
preferred	우선의, 선호되는
prevent	~을 막다, ~을 예방하다
prior to	~이전에
proceed	(일이)행해지다, 진척되다
processing	처리, 가공
procurement	조달
produce	생산하다
production	생산, 생산량
profit	이익, 수익
projection	예상, 예상치
properly	제대로, 정확하게
proportion	부분, 몫
proposal	계획, 안
protective	보호하는
provide	공급하다, 제공하다
provision	(조약의)조항
proximity	가까움, 근접함
quality	품질, 질
quota	할당량, 할당
quote	견적액
rate	요금
rebate	환ㅂ루하다, 리베이트 하다
recent	최근의
recently	최근에
reception	환영회; 접수처
recipe	요리법, 조리법
recipient	수신자
reciprocal	상호의, 서로의
reduce	줄이다, 감소시키다
refuse	거절하다
regular	정기적인; 단골의
reimburse	변제하다, 상환하다
reliable	믿을 만한, 신뢰할 수 있는
remarkable	현저한, 두드러진
remittance	송금
renew	갱신하다
replace	~을 교체하다, 대체하다
represent	~을 대표하다
representative	판매 대리인, 세일즈맨; 대표자
research	연구, 조사
reservation	예약
respond	응답하다
retail	소매
retain	보유하다, 유지하다
retaliation	보복
return	반환하다, 반송하다
revenue	수입
review	검토하다, 재조사하다
revolutionary	혁명적인
rigid	엄격한, 완고한
rigorously	엄격히
round trip	왕복 여행
safety	안전
sale	(-s)매출액, 매상고; 재고 정리 판매
satisfaction	만족
satisfactory	만족스러운
seating	좌석 설비; 좌석배열
selection	선택된 것, 정선품
separately	개별적으로, 따로따로
seriously	진지하게
settle	해결하다, 처리하다
shipment	선적, 발송; 탁송화물
short	부족한
shortly	곧, 얼마 안 있어
significantly	상당히, 두드러지게
sleek	세련된
slightly	약간
solicit	요청하다, 간청하다
specific	구체적인, 명확한
specification	명세서, 설명서
spend	~을 쓰다, 소비하다
stage	단계
state-of-the-art	최신식의
step	단계, 수단
stipulation	계약조건
stir	휘젓다, 뒤섞다
stock	재고; 주식
streamline	능률적으로 하다, 합리화 하다
stringently	엄격히, 엄중하게
subject	~의 영향을 받기 쉬운;(동의 등을) 조건으로 하는;~에게 (~을) 받게하다
substantial	상당한
substantially	크게, 상당히
sufficiently	충분히
summarize	요약하다
superb	뛰어난, 최고의
superior	우수한, 상급의
supply	공급하다, 제공하다
surely	틀림없이, 꼭
surplus	잉여, 흑자
swap	맞바꾸다, 교환하다
taste	~의 맛을 보다, 시식하다
technical	기술적인
temporarily	일시적으로
tend	~하는 경향이 있다, ~ 하기 쉽다
term	조건; 임기, 기한
terminate	끝내다, 종결시키다
tolerance	관용
total	총계의, 전부의
touch down	착륙하다
tour	견학, 짧은 여행
turnover	총 매상고, 거래액; 이직률
unable	~할 수 없는
unavailable	구할 수 없는, 이용할 수 없는
unique	독특한
unlimited	무제한의
unusually	유난히, 비정상적으로
unwavering	확고한, 동요하지 않는
utensil	(부엌에서 쓰는)도구, 기구
utilize	이용하다, 활용하다
vulnerable	취약한
worth	~의 가치가 있는
